1111111111111111111111111111
100000000000000000P000000001
10E0000000000000000000C00001
1111111111111111111111111111