1111111111111111111111111111
10000000000000000P0000000001
10E0000000000000000000000001
1111111111111111111111111111