1111111111111111111111111111
100000000000000000P000000001
10E000000000000C000000000001
1111111111111111111111111111